


@###################################################################@
@                                                                   @
@                                                                   @
@                                                                   @
@                                                                   @
@                                                                   @
@                                                                   @
@######                                                             @
@.....@                                                             @
@..@..@                                                             @
@..@..@...@                                                         @
@..@..@...@                                                         @
@..@......@                                                         @
@..@###@..@                                                         @
@......@..@                                                         @
@..#...@..@                                                         @
@..#...@..@
@..#...@..@                                                         @
@......@..@                                                         @
@..#####..@                                                         @
@..@......@                                                         @
@..@...###@                                                         @
@..@...@                                                            @
...@...@                                                            @
#####################################################################