
 @#################################################################################@
 @...................................................................@
 @@@@@@@@@@@@@@......................................................@
 @............@......................................................@
 @.....@......@@@@@@@....@@@@@@@@@@@.................................@
 @..@@@@............@.........@......................................@
 @............@.....@....@....@......................................@
 @.....@......@.....@....@....@......................................@
 @@@...@......@.....@....@....@......................................@
 @.....@......@..........@...........................................@
 @.....@......@..........@...........................................@
 @.....@.............................................................@
 @.....@.............................................................@
 @.....@@@@@@@@@@@@@.................................................@
 @.................@.................................................@
 @.................@.................................................@
 @@@@@@@@@@@@@@......................................................@
 @............@......................................................@
 @.....@......@@@@@@@....@@@@@@@@@@@.................................@
 @..@@@@............@.........@......................................@
 @.....@............@.........@......................................@
 @.....@......@.....@....@....@......................................@
 @@@...@......@.....@....@....@......................................@
 @.....@......@..........@...........................................@
 @.....@......@..........@...........................................@
 @...................................................................@
 @...................................................................@
 @...................................................................@
 #####################################################################