


@###################################################################@
@.........                                                          @
@.........                                                          @
@.....@..@                                                          @
@.....@..@                                                          @
@.....@..@                                                          @
@.....@..@                                                          @
@#####@..@                                                          @
@.....@..@                                                          @
@..@..@..@@@@                                                       @
@..@..@...@@@..@                                                    @
@..@..@...@@@..@                                                    @
@..@......@@@..@                                                    @
@..####@..@@@..@                                                    @
@......@..@@@..@                                                    @
@..@...@..@@@..@                                                    @
@..@...@..@@@..@
@..@...@..@@@..@..                                                  @
@......@..@##..##@                                                  @
@..@####..@......@                                                  @
@..@......@..@@..@                                                  @
@..@...####..@@..@                                                  @
@..@.............@                                                  @
...@.............@                                                  @
#####################################################################