 #############################################################################################
 @...........................................................................................@
 @...........................................................................................@
 @...........................................................................................@
 @...........................................................................................@
 @...........................................................................................@
 @...........................................................................................@
 @...........................................................................................@
 @@@@@@@@@@@@@@..............................................................................@
 @............@..............................................................................@
 @.....@......@@@@@@@....@@@@@@@@@@@.........................................................@
 @..@@@@............@.........@..............................................................@
 @............@.....@....@....@..............................................................@
 @...........................................................................................@
 #############################################################################################